el fin de semana - helgen
libro - bok
libre - fri
el otro día - häromdagen
largo - lång/längd
me gusta - jag gillar det
majo - snäll (Spanien)
para que - in order to
grabar - to record
es el caso - it is the case
ha hecho - he/she has done
he hecho - I have done
has hecho - you have done
han hecho - they have done
comí - I ate
comiste - you ate
comió - he/she ate
me costó - it cost me/it was difficult for me
cuéntame - tell me
invitado - gäst
sus - their
reto - utmaning
tomé - I took
como - like, liksom
era - I was/it was
la razón - the reason
tienes razón - you're right
he ido - I've been
a lo largo de este tiempo - throughout this time
dejar - to leave
hemos ido - we've been
iba - I was going
iba - he/she was going
la capital - huvudstaden
asimismo - likewise
se nota que - you can notice that..
la actitud - attityden
tercer - tredje
sino - but (not this but that)
experimentar - to experience
ligeramente - slightly
la mitad - half
tiene que ver con - det har att göra med