el agua - vatten (el agua sienta bien)
rayada, rayado - randing (la falda es rayada)
delgada, delgado - smal (soy delgada)
allí - där (fuimos allí por tren)
trabajadora, trabajador - [en] hardworking (mi novio es muy trabajador)
barata, barato - billig (es una tienda barata)
el vestido - klänning (el vestido rojo)
preciosa, precioso - [en] lovely (es un día precioso)
emocionante - [en] exiting (me parece muy emocionante)
el gorro - mössa (trae un gorro y un bañador)
el bañador - baddräkt (me encanta mi nuevo bañador)
el abrigo - rock (un abrigo rojo trae alegría cuando está gris afuera)
suave - mjuk (su piel es tan suave)
el descanso - paus (necesito un descanso)
la manta - filt (tenemos muchas mantas en el barco)
la habitación - rum (nuestra habitación era bonita)
la cartera - plånbok (no traje mi cartera)
debajo - under (debajo de la mesa)
el cabello - hår (ella tiene cabello rizado)
la mano - hand (lo tengo en la mano)
la rodilla - knä (me duele la rodilla)
el brazo - arm (él solo tiene un brazo)
el hombro - axel (tocarse los homros)
el pecho - [en] chest (camiseta con estampado en el pecho)
la cadera - höft (el movimiento empieza en la cadera)
el ojo - öga (tengo los ojos verdes)
la oreja - öra (ella tiene las orejas pequeñas)
el dedo - finger/tå (tengo los pies tan fríos que ya no siento los dedos)
la espalda - rygg (te veo venir con la espalda pintada)
la cabeza - huvud (me duele la cabeza)
la barriga - [en] belly (el hombre tiene la barriga cervecera)
el diente - tand (me falta dos dientes)
la pierna - benet
el pie - foten
yo hago - jag gör 
yo estoy haciendo - jag håller på att göra 
yo he hecho - jag har gjort 
yo estuve haciendo - jag höll på att göra 
anoche - last night [en]
yo estuve - jag var (tillfälligt)
tú estuviste - du var (tillfälligt)
ella estuvo - hon var (tillfälligt)
él estuvo - han var (tillfälligt)
agradable - nice [en] 
agrio - sur 
amargo - bitter 
enviar - skicka 